Background:
OP  OP  OP  OP  OP  OP  OP  OP  OP  OP  OP  OP  OP  OP  OP  OP  OP  OP  OP  OP  OP  OP  OP  OP  OP  OP  OP  OP  OP  OP  OP  OP  OP  OP  OP  OP  OP  OP  OP  OP  
WL  OP  OP  OP  OP  OP  OP  OP  OP  OP  OP  OP  OP  OP  OP  OP  OP  OP  OP  OP  OP  OP  OP  OP  OP  OP  OP  OP  OP  OP  OP  OP  OP  OP  OP  OP  OP  OP  OP  OP  
WL  OP  OP  OP  OP  OP  OP  OP  OP  OP  OP  OP  OP  OP  OP  OP  OP  OP  OP  OP  OP  OP  OP  OP  OP  OP  OP  OP  OP  OP  OP  OP  OP  OP  OP  OP  OP  OP  OP  OP  
WL  OP  OP  OP  OP  OP  OP  OP  OP  OP  OP  OP  OP  OP  OP  OP  OP  OP  OP  OP  OP  OP  OP  OP  OP  OP  OP  OP  OP  OP  OP  OP  OP  OP  OP  OP  OP  OP  OP  OP  
WL  OP  OP  OP  OP  OP  OP  OP  OP  OP  OP  OP  OP  OP  OP  OP  OP  OP  OP  OP  OP  OP  OP  OP  OP  OP  OP  OP  OP  OP  OP  OP  OP  OP  OP  OP  OP  OP  OP  OP  
OP  OP  OP  OP  OP  OP  OP  OP  OP  OP  OP  OP  OP  OP  OP  OP  OP  OP  OP  OP  OP  OP  OP  OP  OP  OP  OP  OP  OP  OP  OP  OP  OP  OP  OP  OP  OP  OP  OP  OP  
OP  OP  OP  OP  OP  OP  OP  OP  OP  OP  OP  OP  OP  OP  OP  OP  OP  OP  OP  OP  OP  OP  OP  OP  OP  OP  OP  OP  OP  OP  OP  OP  OP  OP  OP  OP  OP  OP  OP  OP  
OP  OP  OP  OP  OP  OP  OP  OP  OP  OP  OP  OP  OP  OP  OP  OP  OP  OP  OP  OP  OP  OP  OP  OP  OP  OP  OP  OP  OP  OP  OP  OP  OP  OP  OP  OP  OP  OP  OP  OP  
OP  OP  OP  OP  OP  OP  OP  OP  OP  OP  OP  OP  OP  OP  OP  OP  OP  OP  OP  OP  OP  OP  OP  OP  OP  OP  OP  OP  OP  OP  OP  OP  OP  OP  OP  OP  OP  OP  OP  OP  
OP  OP  OP  OP  OP  OP  OP  OP  OP  OP  OP  OP  OP  OP  OP  OP  OP  OP  OP  OP  OP  OP  OP  OP  OP  OP  OP  OP  OP  OP  OP  OP  OP  OP  OP  OP  OP  OP  OP  OP  
OP  OP  OP  OP  OP  OP  OP  OP  OP  OP  OP  OP  OP  OP  OP  OP  OP  OP  OP  OP  OP  OP  OP  OP  OP  OP  OP  OP  OP  OP  OP  OP  OP  OP  OP  OP  OP  OP  OP  OP  
OP  OP  OP  OP  OP  OP  OP  OP  OP  OP  OP  OP  OP  OP  OP  OP  OP  OP  OP  OP  OP  OP  OP  OP  OP  OP  OP  OP  OP  OP  OP  OP  OP  OP  OP  OP  OP  OP  OP  OP  
OP  OP  OP  OP  OP  OP  OP  OP  OP  OP  OP  OP  OP  OP  OP  OP  OP  OP  OP  OP  OP  OP  OP  OP  OP  OP  OP  OP  OP  OP  OP  OP  OP  OP  OP  OP  OP  OP  OP  OP  
OP  OP  OP  OP  OP  OP  OP  OP  OP  OP  OP  OP  OP  OP  OP  OP  OP  OP  OP  OP  OP  OP  OP  OP  OP  OP  OP  OP  OP  OP  OP  OP  OP  OP  OP  OP  OP  OP  OP  OP  
OP  OP  OP  OP  OP  OP  OP  OP  OP  OP  OP  OP  OP  OP  OP  OP  OP  OP  OP  OP  OP  OP  OP  OP  OP  OP  OP  OP  OP  OP  OP  OP  OP  OP  OP  OP  OP  OP  OP  OP  
OP  OP  OP  OP  OP  OP  OP  OP  OP  OP  OP  OP  OP  OP  OP  OP  OP  OP  OP  OP  OP  OP  OP  OP  OP  OP  OP  OP  OP  OP  OP  OP  OP  OP  OP  OP  OP  OP  OP  OP  
OP  OP  OP  OP  OP  OP  OP  OP  OP  OP  OP  OP  OP  OP  OP  OP  OP  OP  OP  OP  OP  OP  OP  OP  OP  OP  OP  OP  OP  OP  OP  OP  OP  OP  OP  OP  OP  OP  OP  OP  
OP  OP  OP  OP  OP  OP  OP  OP  OP  OP  OP  OP  OP  OP  OP  OP  OP  OP  OP  OP  OP  OP  OP  OP  OP  OP  OP  OP  OP  OP  OP  OP  OP  OP  OP  OP  OP  OP  OP  OP  
OP  OP  OP  OP  OP  OP  OP  OP  OP  OP  OP  OP  OP  OP  OP  OP  OP  OP  OP  OP  OP  OP  OP  OP  OP  OP  OP  OP  OP  OP  OP  OP  OP  OP  OP  OP  OP  OP  OP  OP  
OP  OP  OP  OP  OP  OP  OP  OP  OP  OP  OP  OP  OP  OP  OP  OP  OP  OP  OP  OP  OP  OP  OP  OP  OP  OP  OP  OP  OP  OP  OP  OP  OP  OP  OP  OP  OP  OP  OP  OP  
OP  OP  OP  OP  OP  OP  OP  OP  OP  OP  OP  OP  OP  OP  OP  OP  OP  OP  OP  OP  OP  OP  OP  OP  OP  OP  OP  OP  OP  OP  OP  OP  OP  OP  OP  OP  OP  OP  OP  OP  
OP  OP  OP  OP  OP  OP  OP  OP  OP  OP  OP  OP  OP  OP  OP  OP  OP  OP  OP  OP  OP  OP  OP  OP  OP  OP  OP  OP  OP  OP  OP  OP  OP  OP  OP  OP  OP  OP  OP  OP  
OP  OP  OP  OP  OP  OP  OP  OP  OP  OP  OP  OP  OP  OP  OP  OP  OP  OP  OP  OP  OP  OP  OP  OP  OP  OP  OP  OP  OP  OP  OP  OP  OP  OP  OP  OP  OP  OP  OP  OP  
OP  OP  OP  OP  OP  OP  OP  OP  OP  OP  OP  OP  OP  OP  OP  OP  OP  OP  OP  OP  OP  OP  OP  OP  OP  OP  OP  OP  OP  OP  OP  OP  OP  OP  OP  OP  OP  OP  OP  WL  
OP  OP  OP  OP  OP  OP  OP  OP  OP  OP  OP  OP  OP  OP  OP  OP  OP  OP  OP  OP  OP  OP  OP  OP  OP  OP  OP  OP  OP  OP  OP  OP  OP  OP  OP  OP  OP  OP  OP  OP  
OP  OP  OP  OP  OP  OP  OP  OP  OP  OP  OP  OP  OP  OP  OP  OP  OP  OP  OP  OP  OP  OP  OP  OP  OP  OP  OP  OP  OP  OP  OP  OP  OP  OP  OP  OP  OP  OP  OP  OP  
OP  OP  OP  OP  OP  OP  OP  OP  OP  OP  OP  OP  OP  OP  OP  OP  OP  OP  OP  OP  OP  OP  OP  OP  OP  OP  OP  OP  OP  OP  OP  OP  OP  OP  OP  OP  OP  OP  OP  OP  
OP  OP  OP  OP  OP  OP  OP  OP  OP  OP  OP  OP  OP  OP  OP  OP  OP  OP  OP  OP  OP  OP  OP  OP  OP  OP  OP  OP  OP  OP  OP  OP  OP  OP  OP  OP  OP  OP  OP  OP  
OP  OP  OP  OP  OP  OP  OP  OP  OP  OP  OP  OP  OP  OP  OP  OP  OP  OP  OP  OP  OP  OP  OP  OP  OP  OP  OP  OP  OP  OP  OP  OP  OP  OP  OP  OP  OP  OP  OP  OP  
WL  WL  WL  WL  WL  WL  WL  WL  WL  WL  WL  WL  WL  WL  WL  WL  WL  WL  WL  WL  WL  WL  WL  WL  WL  WL  WL  WL  WL  WL  WL  WL  WL  WL  WL  WL  WL  WL  WL  WL  
#
#
Player:
1 1
3 1
