Background:
OP  OP  OP  OP  OP  OP  OP  OP  OP  OP  OP  OP  OP  OP  OP  OP  OP  OP  OP  OP  OP  OP  OP  OP  OP  OP  OP  OP  OP  OP  OP  OP  OP  OP  OP  OP  OP  OP  OP  OP  
WL  OP  OP  OP  OP  OP  OP  OP  OP  OP  OP  OP  OP  OP  OP  OP  OP  OP  OP  OP  OP  OP  OP  OP  OP  OP  OP  OP  OP  OP  OP  OP  OP  OP  OP  OP  OP  OP  OP  OP  
WL  OP  OP  OP  OP  OP  OP  OP  OP  OP  OP  OP  OP  OP  OP  OP  OP  OP  OP  OP  OP  OP  OP  OP  OP  OP  OP  OP  OP  OP  OP  OP  OP  OP  OP  OP  OP  OP  OP  OP  
WL  OP  OP  OP  OP  OP  OP  OP  OP  OP  OP  OP  OP  OP  OP  OP  OP  OP  OP  OP  OP  OP  OP  OP  OP  OP  OP  OP  OP  OP  OP  OP  OP  OP  OP  OP  OP  OP  OP  OP  
WL  OP  OP  OP  OP  OP  OP  OP  OP  OP  OP  OP  OP  OP  OP  OP  OP  OP  OP  OP  OP  OP  OP  OP  OP  OP  OP  OP  OP  OP  OP  OP  OP  OP  OP  OP  OP  OP  OP  OP  
OP  OP  OP  OP  OP  OP  OP  OP  OP  OP  OP  OP  OP  OP  OP  OP  OP  OP  OP  OP  OP  OP  OP  OP  OP  OP  OP  OP  OP  OP  OP  OP  OP  OP  OP  OP  OP  OP  OP  OP  
OP  OP  OP  OP  OP  OP  OP  OP  OP  OP  OP  OP  OP  OP  OP  OP  OP  OP  OP  OP  OP  OP  OP  OP  OP  OP  OP  OP  OP  OP  OP  OP  OP  OP  OP  OP  OP  OP  OP  OP  
OP  OP  OP  OP  OP  OP  OP  OP  OP  OP  OP  OP  OP  OP  OP  OP  OP  OP  OP  OP  OP  OP  OP  OP  OP  OP  OP  OP  OP  OP  OP  OP  OP  OP  OP  OP  OP  OP  OP  OP  
OP  OP  OP  OP  OP  OP  OP  OP  OP  OP  OP  OP  OP  OP  OP  OP  OP  OP  OP  OP  OP  OP  OP  OP  OP  OP  OP  OP  OP  OP  OP  OP  OP  OP  OP  OP  OP  OP  OP  OP  
OP  OP  OP  OP  OP  OP  OP  OP  OP  OP  OP  OP  OP  OP  OP  OP  OP  OP  OP  OP  OP  OP  OP  OP  OP  OP  OP  OP  OP  OP  OP  OP  OP  OP  OP  OP  OP  OP  OP  OP  
OP  OP  OP  OP  OP  OP  OP  OP  OP  OP  OP  OP  OP  OP  OP  OP  OP  OP  OP  OP  OP  OP  OP  OP  OP  OP  OP  OP  OP  OP  OP  OP  OP  OP  OP  OP  OP  OP  OP  OP  
OP  OP  OP  OP  OP  OP  OP  OP  OP  OP  OP  OP  OP  OP  OP  OP  OP  OP  OP  OP  OP  OP  OP  OP  OP  OP  OP  OP  OP  OP  OP  OP  OP  OP  OP  OP  OP  OP  OP  OP  
OP  OP  OP  OP  OP  OP  OP  OP  OP  OP  OP  OP  OP  OP  OP  OP  OP  OP  OP  OP  OP  OP  OP  OP  OP  OP  OP  OP  OP  OP  OP  OP  OP  OP  OP  OP  OP  OP  OP  OP  
OP  OP  OP  OP  OP  OP  OP  OP  OP  OP  OP  OP  OP  OP  OP  OP  OP  OP  OP  OP  OP  OP  OP  OP  OP  OP  OP  OP  OP  OP  OP  OP  OP  OP  OP  OP  OP  OP  OP  OP  
OP  OP  OP  OP  OP  OP  OP  OP  OP  OP  OP  OP  OP  OP  OP  OP  OP  OP  OP  OP  OP  OP  OP  OP  OP  OP  OP  OP  OP  OP  OP  OP  OP  OP  OP  OP  OP  OP  OP  OP  
OP  OP  OP  OP  OP  OP  OP  OP  OP  OP  OP  OP  OP  OP  OP  OP  OP  OP  OP  OP  OP  OP  OP  OP  OP  OP  OP  OP  OP  OP  OP  OP  OP  OP  OP  OP  OP  OP  OP  OP  
OP  OP  OP  OP  OP  OP  OP  OP  OP  OP  OP  OP  OP  OP  OP  OP  OP  OP  OP  OP  OP  OP  OP  OP  OP  OP  OP  OP  OP  OP  OP  OP  OP  OP  OP  OP  OP  OP  OP  OP  
OP  OP  OP  OP  OP  OP  OP  OP  OP  OP  OP  OP  OP  OP  OP  OP  OP  OP  OP  OP  OP  OP  OP  OP  OP  OP  OP  OP  OP  OP  OP  OP  OP  OP  OP  OP  OP  OP  OP  OP  
OP  OP  OP  OP  OP  OP  OP  OP  OP  OP  OP  OP  OP  OP  OP  OP  OP  OP  OP  OP  OP  OP  OP  OP  OP  OP  OP  OP  OP  OP  OP  OP  OP  OP  OP  OP  OP  OP  OP  OP  
OP  OP  OP  OP  OP  OP  OP  OP  OP  OP  OP  OP  OP  OP  OP  OP  OP  OP  OP  OP  OP  OP  OP  OP  OP  OP  OP  OP  OP  OP  OP  OP  OP  OP  OP  OP  OP  OP  OP  OP  
OP  OP  OP  OP  OP  OP  OP  OP  OP  OP  OP  OP  OP  OP  OP  OP  OP  OP  OP  OP  OP  OP  OP  OP  OP  OP  OP  OP  OP  OP  OP  OP  OP  OP  OP  OP  OP  OP  OP  OP  
OP  OP  OP  OP  OP  OP  OP  OP  OP  OP  OP  OP  OP  OP  OP  OP  OP  OP  OP  OP  OP  OP  OP  OP  OP  OP  OP  OP  OP  OP  OP  OP  OP  OP  OP  OP  OP  OP  OP  OP  
OP  OP  OP  OP  OP  OP  OP  OP  OP  OP  OP  OP  OP  OP  OP  OP  OP  OP  OP  OP  OP  OP  OP  OP  OP  OP  OP  OP  OP  OP  OP  OP  OP  OP  OP  OP  OP  OP  OP  OP  
OP  OP  OP  OP  OP  OP  OP  OP  OP  OP  OP  OP  OP  OP  OP  OP  OP  OP  OP  OP  OP  OP  OP  OP  OP  OP  OP  OP  OP  OP  OP  OP  OP  OP  OP  OP  OP  OP  OP  WL  
OP  OP  OP  OP  OP  OP  OP  OP  OP  OP  OP  OP  OP  OP  OP  OP  OP  OP  OP  OP  OP  OP  OP  OP  OP  OP  OP  OP  OP  OP  OP  OP  OP  OP  OP  OP  OP  OP  OP  OP  
OP  OP  OP  OP  OP  OP  OP  OP  OP  OP  OP  OP  OP  OP  OP  OP  OP  OP  OP  OP  OP  OP  OP  OP  OP  OP  OP  OP  OP  OP  OP  OP  OP  OP  OP  OP  OP  OP  OP  OP  
OP  OP  OP  OP  OP  OP  OP  OP  OP  OP  OP  OP  OP  OP  OP  OP  OP  OP  OP  OP  OP  OP  OP  OP  OP  OP  OP  OP  OP  OP  OP  OP  OP  OP  OP  OP  OP  OP  OP  OP  
OP  OP  OP  OP  OP  OP  OP  OP  OP  OP  OP  OP  OP  OP  OP  OP  OP  OP  OP  OP  OP  OP  OP  OP  OP  OP  OP  OP  OP  OP  OP  OP  OP  OP  OP  OP  OP  OP  OP  OP  
OP  OP  OP  OP  OP  OP  OP  OP  OP  OP  OP  OP  OP  OP  OP  OP  OP  OP  OP  OP  OP  OP  OP  OP  OP  OP  OP  OP  OP  OP  OP  OP  OP  OP  OP  OP  OP  OP  OP  OP  
OP  OP  OP  OP  OP  OP  OP  OP  OP  OP  OP  OP  OP  OP  OP  OP  OP  OP  OP  OP  OP  OP  OP  OP  OP  OP  OP  OP  OP  OP  OP  OP  OP  OP  OP  OP  OP  OP  OP  OP  
