Background:
OP  OP  OP  OP  OP  OP  OP  OP  OP  OP  OP  OP  OP  OP  OP  OP  OP  OP  OP  OP  OP  OP  OP  OP  OP  OP  OP  OP  OP  OP  OP  OP  OP  OP  OP  OP  OP  OP  OP  OP  
WL  OP  OP  OP  OP  WL  OP  OP  OP  OP  OP  OP  OP  OP  OP  OP  OP  OP  OP  OP  OP  OP  OP  OP  OP  OP  OP  OP  OP  OP  OP  OP  OP  OP  OP  OP  OP  OP  OP  OP  
WL  OP  OP  OP  OP  OP  OP  OP  OP  OP  OP  OP  OP  OP  OP  OP  OP  OP  OP  OP  OP  OP  OP  OP  OP  OP  OP  OP  OP  OP  OP  OP  OP  OP  OP  OP  OP  OP  OP  OP  
WL  OP  OP  OP  OP  OP  OP  OP  OP  OP  OP  OP  OP  OP  OP  OP  OP  OP  OP  OP  OP  OP  OP  OP  OP  OP  OP  OP  OP  OP  OP  OP  OP  OP  OP  OP  OP  OP  OP  OP  
WL  OP  OP  OP  OP  OP  OP  OP  OP  OP  OP  OP  OP  OP  OP  OP  OP  OP  OP  OP  OP  OP  OP  OP  OP  OP  OP  OP  OP  OP  OP  OP  OP  OP  OP  OP  OP  OP  OP  OP  
OP  OP  OP  WL  OP  OP  OP  OP  OP  OP  OP  OP  OP  OP  OP  OP  OP  OP  OP  OP  OP  OP  OP  OP  OP  OP  OP  OP  OP  OP  OP  OP  OP  OP  OP  OP  OP  OP  OP  OP  
OP  OP  OP  OP  OP  OP  OP  OP  OP  OP  OP  OP  OP  OP  OP  OP  OP  OP  OP  OP  OP  OP  OP  OP  OP  OP  OP  OP  OP  OP  OP  OP  OP  OP  OP  OP  OP  OP  OP  OP  
OP  OP  OP  OP  OP  OP  OP  OP  OP  OP  OP  OP  OP  OP  OP  OP  OP  OP  OP  OP  OP  OP  OP  OP  OP  OP  OP  OP  OP  OP  OP  OP  OP  OP  OP  OP  OP  OP  OP  OP  
OP  OP  OP  OP  OP  OP  OP  OP  OP  OP  OP  OP  OP  OP  OP  OP  OP  OP  OP  OP  OP  OP  OP  OP  OP  OP  OP  OP  OP  OP  OP  OP  OP  OP  OP  OP  OP  OP  OP  OP  
OP  WL  OP  OP  OP  WL  OP  OP  OP  OP  OP  OP  OP  OP  OP  OP  OP  OP  OP  OP  OP  OP  OP  OP  OP  OP  OP  OP  OP  OP  OP  OP  OP  OP  OP  OP  OP  OP  OP  OP  
OP  OP  OP  OP  OP  OP  OP  OP  OP  OP  OP  OP  OP  OP  OP  OP  OP  OP  OP  OP  OP  OP  OP  OP  OP  OP  OP  OP  OP  OP  OP  OP  OP  OP  OP  OP  OP  OP  OP  OP  
OP  OP  OP  OP  OP  OP  OP  OP  OP  OP  OP  OP  OP  OP  OP  OP  OP  OP  OP  OP  OP  OP  OP  OP  OP  OP  OP  OP  OP  OP  OP  OP  OP  OP  OP  OP  OP  OP  OP  OP  
OP  OP  OP  OP  OP  OP  OP  OP  OP  OP  OP  OP  OP  OP  OP  OP  OP  OP  OP  OP  OP  OP  OP  OP  OP  OP  OP  OP  OP  OP  OP  OP  OP  OP  OP  OP  OP  OP  OP  OP  
OP  OP  OP  WL  OP  OP  OP  OP  OP  OP  OP  OP  OP  OP  OP  OP  OP  OP  OP  OP  OP  OP  OP  OP  OP  OP  OP  OP  OP  OP  OP  OP  OP  OP  OP  OP  OP  OP  OP  OP  
OP  OP  OP  OP  OP  OP  OP  OP  OP  OP  OP  OP  OP  OP  OP  OP  OP  OP  OP  OP  OP  OP  OP  OP  OP  OP  OP  OP  OP  OP  OP  OP  OP  OP  OP  OP  OP  OP  OP  OP  
OP  OP  OP  OP  OP  OP  OP  OP  OP  OP  OP  OP  OP  OP  OP  OP  OP  OP  OP  OP  OP  OP  OP  OP  OP  OP  OP  OP  OP  OP  OP  OP  OP  OP  OP  OP  OP  OP  OP  OP  
OP  OP  OP  OP  OP  OP  OP  OP  OP  OP  OP  OP  OP  OP  OP  OP  OP  OP  OP  OP  OP  OP  OP  OP  OP  OP  OP  OP  OP  OP  OP  OP  OP  OP  OP  OP  OP  OP  OP  OP  
OP  WL  OP  OP  OP  WL  OP  OP  OP  OP  OP  OP  OP  OP  OP  OP  OP  OP  OP  OP  OP  OP  OP  OP  OP  OP  OP  OP  OP  OP  OP  OP  OP  OP  OP  OP  OP  OP  OP  OP  
OP  OP  OP  OP  OP  OP  OP  OP  OP  OP  OP  OP  OP  OP  OP  OP  OP  OP  OP  OP  OP  OP  OP  OP  OP  OP  OP  OP  OP  OP  OP  OP  OP  OP  OP  OP  OP  OP  OP  OP  
OP  OP  OP  OP  OP  OP  OP  OP  OP  OP  OP  OP  OP  OP  OP  OP  OP  OP  OP  OP  OP  OP  OP  OP  OP  OP  OP  OP  OP  OP  OP  OP  OP  OP  OP  OP  OP  OP  OP  OP  
OP  OP  OP  OP  OP  OP  OP  OP  OP  OP  OP  OP  OP  OP  OP  OP  OP  OP  OP  OP  OP  OP  OP  OP  OP  OP  OP  OP  OP  OP  OP  OP  OP  OP  OP  OP  OP  OP  OP  OP  
OP  OP  OP  WL  OP  OP  OP  OP  OP  OP  OP  OP  OP  OP  OP  OP  OP  OP  OP  OP  OP  OP  OP  OP  OP  OP  OP  OP  OP  OP  OP  OP  OP  OP  OP  OP  OP  OP  OP  OP  
OP  OP  OP  OP  OP  OP  OP  OP  OP  OP  OP  OP  OP  OP  OP  OP  OP  OP  OP  OP  OP  OP  OP  OP  OP  OP  OP  OP  OP  OP  OP  OP  OP  OP  OP  OP  OP  OP  OP  OP  
OP  OP  OP  OP  OP  OP  OP  OP  OP  OP  OP  OP  OP  OP  OP  OP  OP  OP  OP  OP  OP  OP  OP  OP  OP  OP  OP  OP  OP  OP  OP  OP  OP  OP  OP  OP  OP  OP  OP  WL  
OP  OP  OP  OP  OP  OP  OP  OP  OP  OP  OP  OP  OP  OP  OP  OP  OP  OP  OP  OP  OP  OP  OP  OP  OP  OP  OP  OP  OP  OP  OP  OP  OP  OP  OP  OP  OP  OP  OP  OP  
OP  WL  OP  OP  OP  WL  OP  OP  OP  OP  OP  OP  OP  OP  OP  OP  OP  OP  OP  OP  OP  OP  OP  OP  OP  OP  OP  OP  OP  OP  OP  OP  OP  OP  OP  OP  OP  OP  OP  OP  
OP  OP  OP  OP  OP  OP  OP  OP  OP  OP  OP  OP  OP  OP  OP  OP  OP  OP  OP  OP  OP  OP  OP  OP  OP  OP  OP  OP  OP  OP  OP  OP  OP  OP  OP  OP  OP  OP  OP  OP  
OP  OP  OP  OP  OP  OP  OP  OP  OP  OP  OP  OP  OP  OP  OP  OP  OP  OP  OP  OP  OP  OP  OP  OP  OP  OP  OP  OP  OP  OP  OP  OP  OP  OP  OP  OP  OP  OP  OP  OP  
OP  OP  OP  OP  OP  OP  OP  OP  OP  OP  OP  OP  OP  OP  OP  OP  OP  OP  OP  OP  OP  OP  OP  OP  OP  OP  OP  OP  OP  OP  OP  OP  OP  OP  OP  OP  OP  OP  OP  OP  
WL  WL  WL  WL  WL  WL  WL  OP  OP  WL  WL  WL  WL  WL  WL  WL  WL  WL  WL  WL  WL  WL  WL  WL  WL  WL  WL  WL  WL  WL  WL  WL  WL  WL  WL  WL  WL  WL  WL  WL  
#
#
Obstical:
PR
Player:
1 1
3 28
Comment:
# A Truly Inspiring Message:
First Level!
So COOL!
